13
5 10
2 2
2 2 2 2 2 2 2 2 2 2 
2 1 1 1 1 1 2 1 1 2 
2 1 1 1 1 1 3 1 1 2 
2 1 1 1 1 1 2 1 1 2 
2 2 2 2 2 2 2 2 2 2 
0 0 0 0 0 0 0 0 0 0 
0 0 0 0 0 0 0 0 0 0 
0 0 0 0 0 0 0 0 1 0 
0 0 0 0 0 0 0 0 0 0 
0 0 0 0 0 0 0 0 0 0 
5.0 8.0 4.0
7 8
6 4
2 2 2 2 2 0 0 0 
2 1 1 1 2 0 0 0 
2 1 1 1 2 2 2 2 
2 1 1 1 2 1 1 2 
2 1 3 1 1 1 1 2 
2 1 1 1 2 1 1 2 
2 2 2 2 2 2 2 2 
0 0 0 0 0 0 0 0 
0 0 1 0 0 0 0 0 
0 0 0 0 0 0 0 0 
0 0 0 0 0 0 0 0 
0 0 0 0 0 0 0 0 
0 0 0 0 0 0 0 0 
0 0 0 0 0 0 0 0 
4.0 8.0 5.599999904632568
7 8
1 3
2 2 2 2 0 0 0 0 
2 1 1 2 2 2 2 2 
2 1 1 1 1 3 1 2 
2 1 1 2 1 1 1 2 
2 1 1 2 2 2 2 2 
2 1 1 2 0 0 0 0 
2 2 2 2 0 0 0 0 
0 0 0 0 0 0 0 0 
0 0 0 0 0 0 0 0 
0 0 0 0 0 0 0 0 
0 0 0 0 0 0 0 0 
0 0 0 0 0 0 0 0 
0 1 0 0 0 0 0 0 
0 0 0 0 0 0 0 0 
4.0 8.0 5.0
9 9
1 3
2 2 2 2 2 0 0 0 0 
2 1 1 1 2 0 2 2 2 
2 1 3 1 2 0 2 1 2 
2 1 3 3 2 0 2 1 2 
2 2 2 1 2 2 2 1 2 
0 2 2 1 1 1 1 1 2 
0 2 1 1 1 2 1 1 2 
0 2 1 1 1 2 2 2 2 
0 2 2 2 2 2 0 0 0 
0 0 0 0 0 0 0 0 0 
0 0 0 0 0 0 0 0 0 
0 0 0 0 0 0 0 1 0 
0 0 0 0 0 0 0 1 0 
0 0 0 0 0 0 0 1 0 
0 0 0 0 0 0 0 0 0 
0 0 0 0 0 0 0 0 0 
0 0 0 0 0 0 0 0 0 
0 0 0 0 0 0 0 0 0 
4.5 8.0 6.0
7 9
7 4
2 2 2 2 2 2 2 2 2 
2 1 1 1 1 2 1 1 2 
2 1 1 1 1 1 3 1 2 
2 1 1 1 1 2 1 1 2 
2 2 2 2 2 2 3 1 2 
0 0 0 0 0 2 1 1 2 
0 0 0 0 0 2 2 2 2 
0 0 0 0 0 0 0 0 0 
0 0 0 0 0 0 0 0 0 
0 0 0 0 0 0 0 0 0 
0 0 0 0 0 0 0 0 0 
0 0 0 0 0 0 0 1 0 
0 0 0 0 0 0 0 1 0 
0 0 0 0 0 0 0 0 0 
4.5 8.0 4.599999904632568
11 22
12 8
0 0 0 0 2 2 2 2 2 0 0 0 0 0 0 0 0 0 0 0 0 0 
0 0 0 0 2 1 1 1 2 0 0 0 0 0 0 0 0 0 0 0 0 0 
0 0 0 0 2 3 1 1 2 0 0 0 0 0 0 0 0 0 0 0 0 0 
0 0 2 2 2 1 1 3 2 2 2 0 0 0 0 0 0 0 0 0 0 0 
0 0 2 1 1 3 1 1 3 1 2 0 0 0 0 0 0 0 0 0 0 0 
2 2 2 1 2 1 2 2 2 1 2 0 0 0 0 0 2 2 2 2 2 2 
2 1 1 1 2 1 2 2 2 1 2 2 2 2 2 2 2 1 1 1 1 2 
2 1 3 1 1 3 1 1 1 1 1 1 1 1 1 1 1 1 1 1 1 2 
2 2 2 2 2 1 2 2 2 2 1 2 1 2 2 2 2 1 1 1 1 2 
0 0 0 0 2 1 1 1 1 1 1 2 2 2 0 0 2 2 2 2 2 2 
0 0 0 0 2 2 2 2 2 2 2 2 0 0 0 0 0 0 0 0 0 0 
0 0 0 0 0 0 0 0 0 0 0 0 0 0 0 0 0 0 0 0 0 0 
0 0 0 0 0 0 0 0 0 0 0 0 0 0 0 0 0 0 0 0 0 0 
0 0 0 0 0 0 0 0 0 0 0 0 0 0 0 0 0 0 0 0 0 0 
0 0 0 0 0 0 0 0 0 0 0 0 0 0 0 0 0 0 0 0 0 0 
0 0 0 0 0 0 0 0 0 0 0 0 0 0 0 0 0 0 0 0 0 0 
0 0 0 0 0 0 0 0 0 0 0 0 0 0 0 0 0 0 0 0 0 0 
0 0 0 0 0 0 0 0 0 0 0 0 0 0 0 0 0 0 0 1 1 0 
0 0 0 0 0 0 0 0 0 0 0 0 0 0 0 0 0 0 0 1 1 0 
0 0 0 0 0 0 0 0 0 0 0 0 0 0 0 0 0 0 0 1 1 0 
0 0 0 0 0 0 0 0 0 0 0 0 0 0 0 0 0 0 0 0 0 0 
0 0 0 0 0 0 0 0 0 0 0 0 0 0 0 0 0 0 0 0 0 0 
11.0 12.0 6.0
10 14
7 4
2 2 2 2 2 2 2 2 2 2 2 2 0 0 
2 1 1 1 1 2 1 1 1 1 1 2 2 2 
2 1 1 1 1 2 1 3 1 1 3 1 1 2 
2 1 1 1 1 2 3 2 2 2 2 1 1 2 
2 1 1 1 1 1 1 1 1 2 2 1 1 2 
2 1 1 1 1 2 1 2 1 1 3 1 2 2 
2 2 2 2 2 2 1 2 2 3 1 3 1 2 
0 0 2 1 3 1 1 3 1 3 1 3 1 2 
0 0 2 1 1 1 1 2 1 1 1 1 1 2 
0 0 2 2 2 2 2 2 2 2 2 2 2 2 
0 0 0 0 0 0 0 0 0 0 0 0 0 0 
0 1 1 0 0 0 0 0 0 0 0 0 0 0 
0 1 1 0 0 0 0 0 0 0 0 0 0 0 
0 1 1 0 0 0 0 0 0 0 0 0 0 0 
0 1 1 0 0 0 0 0 0 0 0 0 0 0 
0 1 1 0 0 0 0 0 0 0 0 0 0 0 
0 0 0 0 0 0 0 0 0 0 0 0 0 0 
0 0 0 0 0 0 0 0 0 0 0 0 0 0 
0 0 0 0 0 0 0 0 0 0 0 0 0 0 
0 0 0 0 0 0 0 0 0 0 0 0 0 0 
7.0 8.0 6.0
11 17
13 2
0 0 0 0 0 0 0 0 2 2 2 2 2 2 2 2 0 
0 0 0 0 0 0 0 0 2 1 1 1 1 1 1 2 0 
0 0 0 0 0 0 0 0 2 1 1 1 1 1 1 2 0 
0 0 0 0 0 0 0 0 2 1 3 2 3 1 2 2 0 
0 0 0 0 0 0 0 0 2 1 3 1 1 3 2 0 0 
0 0 0 0 0 0 0 0 2 2 3 1 3 1 2 0 0 
2 2 2 2 2 2 2 2 2 1 3 1 2 1 2 2 2 
2 1 1 1 1 1 1 2 2 1 3 1 1 3 1 1 2 
2 2 1 1 1 1 1 1 1 3 1 1 3 1 1 1 2 
2 1 1 1 1 1 1 2 2 2 2 2 2 2 2 2 2 
2 2 2 2 2 2 2 2 0 0 0 0 0 0 0 0 0 
0 0 0 0 0 0 0 0 0 0 0 0 0 0 0 0 0 
0 0 0 0 0 0 0 0 0 0 0 0 0 0 0 0 0 
0 0 0 0 0 0 0 0 0 0 0 0 0 0 0 0 0 
0 0 0 0 0 0 0 0 0 0 0 0 0 0 0 0 0 
0 0 0 0 0 0 0 0 0 0 0 0 0 0 0 0 0 
0 0 0 0 0 0 0 0 0 0 0 0 0 0 0 0 0 
0 0 0 0 0 0 0 0 0 0 0 0 0 0 0 0 0 
0 1 1 1 1 0 0 0 0 0 0 0 0 0 0 0 0 
0 0 1 1 1 0 0 0 0 0 0 0 0 0 0 0 0 
0 1 1 1 1 0 0 0 0 0 0 0 0 0 0 0 0 
0 0 0 0 0 0 0 0 0 0 0 0 0 0 0 0 0 
8.5 10.0 6.0
13 17
14 7
0 0 0 0 0 0 0 0 2 2 2 2 2 0 0 0 0 
0 0 0 0 0 0 0 0 2 1 1 1 2 2 2 2 2 
0 0 0 0 0 0 0 0 2 1 2 3 2 2 1 1 2 
0 0 0 0 0 0 0 0 2 1 1 1 1 1 3 1 2 
2 2 2 2 2 2 2 2 2 1 2 2 2 1 1 1 2 
2 1 1 1 1 1 1 2 2 1 3 1 1 3 2 2 2 
2 1 1 1 1 1 1 1 1 3 1 3 3 1 2 2 0 
2 1 1 1 1 1 1 2 2 3 1 1 3 1 1 2 0 
2 2 2 2 2 2 2 2 2 1 1 3 1 1 2 2 0 
0 0 0 0 0 0 0 0 2 1 3 1 3 1 1 2 0 
0 0 0 0 0 0 0 0 2 2 2 1 2 2 1 2 0 
0 0 0 0 0 0 0 0 0 0 2 1 1 1 1 2 0 
0 0 0 0 0 0 0 0 0 0 2 2 2 2 2 2 0 
0 0 0 0 0 0 0 0 0 0 0 0 0 0 0 0 0 
0 0 0 0 0 0 0 0 0 0 0 0 0 0 0 0 0 
0 0 0 0 0 0 0 0 0 0 0 0 0 0 0 0 0 
0 0 0 0 0 0 0 0 0 0 0 0 0 0 0 0 0 
0 0 0 0 0 0 0 0 0 0 0 0 0 0 0 0 0 
0 1 1 1 1 0 0 0 0 0 0 0 0 0 0 0 0 
0 1 1 1 1 0 0 0 0 0 0 0 0 0 0 0 0 
0 1 1 1 1 0 0 0 0 0 0 0 0 0 0 0 0 
0 0 0 0 0 0 0 0 0 0 0 0 0 0 0 0 0 
0 0 0 0 0 0 0 0 0 0 0 0 0 0 0 0 0 
0 0 0 0 0 0 0 0 0 0 0 0 0 0 0 0 0 
0 0 0 0 0 0 0 0 0 0 0 0 0 0 0 0 0 
0 0 0 0 0 0 0 0 0 0 0 0 0 0 0 0 0 
8.5 10.0 7.150000095367432
11 12
9 1
2 2 2 2 2 2 0 0 2 2 2 0 
2 1 1 1 1 2 0 2 2 1 2 2 
2 1 1 1 1 2 2 2 1 1 1 2 
2 1 1 1 1 1 1 1 3 3 1 2 
2 1 1 1 1 2 1 2 1 3 1 2 
2 1 1 2 2 2 1 2 1 3 1 2 
2 2 2 2 1 3 1 2 3 1 1 2 
0 0 0 2 1 1 3 2 1 3 1 2 
0 0 0 2 1 3 1 1 3 1 1 2 
0 0 0 2 1 1 2 2 1 1 1 2 
0 0 0 2 2 2 2 2 2 2 2 2 
0 0 0 0 0 0 0 0 0 0 0 0 
0 1 1 0 0 0 0 0 0 0 0 0 
0 1 1 0 0 0 0 0 0 0 0 0 
0 1 1 0 0 0 0 0 0 0 0 0 
0 1 1 0 0 0 0 0 0 0 0 0 
0 1 1 0 0 0 0 0 0 0 0 0 
0 0 0 0 0 0 0 0 0 0 0 0 
0 0 0 0 0 0 0 0 0 0 0 0 
0 0 0 0 0 0 0 0 0 0 0 0 
0 0 0 0 0 0 0 0 0 0 0 0 
0 0 0 0 0 0 0 0 0 0 0 0 
6.0 8.0 7.0
12 13
5 2
0 0 0 0 0 0 0 2 2 2 2 2 0 
0 2 2 2 2 2 2 2 1 1 1 2 2 
2 2 1 2 1 1 2 2 1 3 3 1 2 
2 1 1 1 1 3 1 1 1 1 1 1 2 
2 1 1 3 1 1 2 2 2 1 1 1 2 
2 2 2 1 2 2 2 2 2 3 2 2 2 
2 1 3 1 1 2 2 2 1 1 1 2 0 
2 1 3 1 3 1 3 1 1 1 1 2 0 
2 1 1 1 1 2 2 2 1 1 1 2 0 
2 1 3 3 1 2 0 2 1 1 1 2 0 
2 1 1 2 2 2 0 2 2 2 2 2 0 
2 2 2 2 0 0 0 0 0 0 0 0 0 
0 0 0 0 0 0 0 0 0 0 0 0 0 
0 0 0 0 0 0 0 0 0 0 0 0 0 
0 0 0 0 0 0 0 0 0 0 0 0 0 
0 0 0 0 0 0 0 0 0 0 0 0 0 
0 0 0 0 0 0 0 0 0 0 0 0 0 
0 0 0 0 0 0 0 0 0 0 0 0 0 
0 0 0 0 0 0 0 0 0 1 1 0 0 
0 0 0 0 0 0 0 0 1 1 1 0 0 
0 0 0 0 0 0 0 0 1 1 1 0 0 
0 0 0 0 0 0 0 0 1 1 1 0 0 
0 0 0 0 0 0 0 0 0 0 0 0 0 
0 0 0 0 0 0 0 0 0 0 0 0 0 
6.5 10.0 6.599999904632568
17 16
1 6
0 0 2 2 2 2 0 0 0 0 0 0 0 0 0 0 
0 0 2 1 1 2 2 2 2 2 2 2 2 2 2 2 
0 0 2 1 1 1 1 3 1 1 1 3 1 3 1 2 
0 0 2 1 3 2 1 3 1 2 1 1 3 1 1 2 
0 0 2 1 1 3 1 3 1 1 2 1 1 1 1 2 
2 2 2 1 3 2 1 2 1 1 2 2 2 2 1 2 
2 1 2 3 1 3 1 3 1 1 2 2 1 1 1 2 
2 1 1 1 1 3 1 2 3 2 1 1 1 2 1 2 
2 2 1 1 3 1 1 1 1 3 1 3 1 3 1 2 
0 2 2 2 2 1 1 2 2 2 2 2 2 2 2 2 
0 0 2 2 2 1 1 2 2 2 0 0 0 0 0 0 
0 0 2 1 1 1 1 1 1 2 0 0 0 0 0 0 
0 0 2 1 1 1 1 1 1 2 0 0 0 0 0 0 
0 0 2 1 1 1 1 1 1 2 0 0 0 0 0 0 
0 0 2 1 1 1 1 1 1 2 0 0 0 0 0 0 
0 0 2 1 1 1 1 1 1 2 0 0 0 0 0 0 
0 0 2 2 2 2 2 2 2 2 0 0 0 0 0 0 
0 0 0 0 0 0 0 0 0 0 0 0 0 0 0 0 
0 0 0 0 0 0 0 0 0 0 0 0 0 0 0 0 
0 0 0 0 0 0 0 0 0 0 0 0 0 0 0 0 
0 0 0 0 0 0 0 0 0 0 0 0 0 0 0 0 
0 0 0 0 0 0 0 0 0 0 0 0 0 0 0 0 
0 0 0 0 0 0 0 0 0 0 0 0 0 0 0 0 
0 0 0 0 0 0 0 0 0 0 0 0 0 0 0 0 
0 0 0 0 0 0 0 0 0 0 0 0 0 0 0 0 
0 0 0 0 0 0 0 0 0 0 0 0 0 0 0 0 
0 0 0 0 0 0 0 0 0 0 0 0 0 0 0 0 
0 0 0 0 0 0 0 0 0 0 0 0 0 0 0 0 
0 0 0 0 0 0 0 0 0 0 0 0 0 0 0 0 
0 0 0 0 0 0 0 0 0 0 0 0 0 0 0 0 
0 0 0 1 1 1 1 1 1 0 0 0 0 0 0 0 
0 0 0 1 1 1 1 1 1 0 0 0 0 0 0 0 
0 0 0 1 1 1 1 1 1 0 0 0 0 0 0 0 
0 0 0 0 0 0 0 0 0 0 0 0 0 0 0 0 
8.0 12.0 9.0
18 17
1 10
0 0 0 0 0 0 0 0 0 0 2 2 2 2 2 2 2 
0 0 0 0 0 0 0 0 0 0 2 1 1 1 1 1 2 
0 0 0 0 0 0 2 2 2 2 2 1 1 1 1 1 2 
0 0 0 0 0 0 2 1 1 1 1 1 1 1 1 1 2 
0 0 0 0 0 0 2 1 1 2 2 1 1 1 1 1 2 
0 0 0 0 0 0 2 2 1 2 2 1 1 1 1 1 2 
0 0 0 0 0 2 2 2 1 2 2 2 2 2 2 2 2 
0 0 0 0 0 2 1 3 3 3 1 2 2 0 0 0 0 
0 2 2 2 2 2 1 1 3 1 3 1 2 2 2 2 2 
2 2 1 1 1 2 3 1 3 1 1 1 2 1 1 1 2 
2 1 1 3 1 1 3 1 1 1 1 3 1 1 3 1 2 
2 2 2 2 2 2 1 3 3 1 3 1 2 2 2 2 2 
0 0 0 0 0 2 1 3 1 1 1 1 2 0 0 0 0 
0 0 0 0 0 2 2 2 2 1 2 2 2 0 0 0 0 
0 0 0 0 0 0 0 0 2 1 1 2 0 0 0 0 0 
0 0 0 0 0 0 0 0 2 1 1 2 0 0 0 0 0 
0 0 0 0 0 0 0 0 2 1 1 2 0 0 0 0 0 
0 0 0 0 0 0 0 0 2 2 2 2 0 0 0 0 0 
0 0 0 0 0 0 0 0 0 0 0 0 0 0 0 0 0 
0 0 0 0 0 0 0 0 0 0 0 0 0 1 1 1 0 
0 0 0 0 0 0 0 0 0 0 0 0 0 1 1 1 0 
0 0 0 0 0 0 0 0 0 0 0 0 0 1 1 1 0 
0 0 0 0 0 0 0 0 0 0 0 0 0 1 1 1 0 
0 0 0 0 0 0 0 0 0 0 0 0 0 1 1 1 0 
0 0 0 0 0 0 0 0 0 0 0 0 0 0 0 0 0 
0 0 0 0 0 0 0 0 0 0 0 0 0 0 0 0 0 
0 0 0 0 0 0 0 0 0 0 0 0 0 0 0 0 0 
0 0 0 0 0 0 0 0 0 0 0 0 0 0 0 0 0 
0 0 0 0 0 0 0 0 0 0 0 0 0 0 0 0 0 
0 0 0 0 0 0 0 0 0 0 0 0 0 0 0 0 0 
0 0 0 0 0 0 0 0 0 0 0 0 0 0 0 0 0 
0 0 0 0 0 0 0 0 0 0 0 0 0 0 0 0 0 
0 0 0 0 0 0 0 0 0 0 0 0 0 0 0 0 0 
0 0 0 0 0 0 0 0 0 0 0 0 0 0 0 0 0 
0 0 0 0 0 0 0 0 0 0 0 0 0 0 0 0 0 
0 0 0 0 0 0 0 0 0 0 0 0 0 0 0 0 0 
8.5 10.5 9.899999618530273
